1111111111111111111111111111111111
1E0000000000000C00000C000000000001
1011110100101000101111000001110101
1110011111111011101001011111C10101
1P0000000C00C0000000010000000100C1
1111111111111111111111111111111111
